A ███████████████████████████████████████████████████████████████████████████████████████████████████
          █         █         █ █ █ █ █     █     █   █ █ █ █   █       █   █         █ █   █       █
█ █████████ █████ █ █ ███ █ ███ █ █ █ █████ █ █ █ █ ███ █ █ █ ███ ███████ █████ ███ █ █ █ █ ███ █ ███
█ █   █ █   █   █ █   █   █ █       █     █   █ █ █ █ █   █ █     █   █   █ █ █   █ █     █     █   █
█ █ █ █ █ █████ █████ █████ █ ███ ███████ █ █ █████ █ ███ █ █ █████ ███ ███ █ ███████ ███ ███████ █ █
█   █         █           █ █   █   █       █   █     █ █   █       █       █           █ █     █ █ █
█ ███ ███ ███ █████ ███████████ █ ███████ ███ █████ ███ █ █████████ █ █████████ ███████ █████ █ █████
█   █ █   █   █ █   █     █     █     █   █       █   █ █ █ █         █       █ █   █   █ █   █   █ █
█████ █ ███████ ███████ █ ███ █ █████ █ █████ █ █████ █ █ █ █ ███████████ █████████ █ ███ ███ ███ █ █
█     █         █     █ █ █   █ █ █ █       █ █     █     █   █ █   █ █ █ █   █       █         █ █ █
█ █████ █████████ ███████ █ █ ███ █ ███ █████████ █ ███ █ █ █ █ ███ █ █ █ ███ ███ ███ █ █ █████ ███ █
█     █ █ █ █       █   █ █ █ █     █     █     █ █ █ █ █ █ █ █   █       █   █     █   █   █       █
███ █████ █ █████ ███ ███ █ █ █ █████ ███ █ █████████ ███ █ █ █ █ █████ █████ █████ █████████ █████ █
█   █       █     █     █ █ █ █ █   █ █   █ █   █     █     █ █ █ █ █ █ █             █       █     █
█ ███████ ███ ███████ ███ ███ █ █ ███ █████ ███ █ ███ █ █████████ █ █ █ ███ █ █████ █ █████████ █ █ █
█       █       █       █   █   █   █   █ █   █     █       █   █     █     █     █ █   █ █ █   █ █ █
█ ███ ███ █████ ███████ █ █ █████ █ █ ███ ███ █████ █████ ███ ███ █████ █ ███ █████████ █ █ ███ ███ █
█ █     █   █     █       █ █     █     █ █ █ █     █       █     █ █   █ █ █ █ █       █   █ █ █   █
███ █ █ █ ███ █ █ ███ █ █ █████ █ █ ███ █ █ █ ███ █████ █ █ █████ █ █████ █ ███ █ ███ ███ ███ ███ █ █
█ █ █ █   █   █ █     █ █     █ █ █   █ █       █   █ █ █ █   █         █     █   █ █     █       █ █
█ █ █ █ █████ █ █████ █ ███ █████████ █ █ ███ █████ █ ███████ █████ █ ███ █ ███████ █████████ █ ███ █
█   █ █   █ █ █ █   █ █   █           █ █ █       █ █ █   █ █     █ █ █   █ █         █ █   █ █   █ █
███████████ █ █████ █████████ ███ ███ █████ █ ███████ █ ███ █ ███ ███ █████ █ ███████ █ ███ ███ █ █ █
█       █ █     █   █ █ █     █     █ █     █   █ █       █ █ █   █   █   █ █   █ █     █     █ █ █ █
█ █ ███ █ ███ ███ █ █ █ ███████ ███ ███ █████ ███ █████ ███ █ ███ █ █████ █ █████ █ █ █████ █ ███████
█ █ █       █     █     █ █   █ █ █   █ █   █         █ █     █           █       █ █       █ █   █ █
█ ███████ █████ ███ █████ █ █ ███ █ █ █ █ █ █ ███ ███ █ █ █ █ █████ █████ █ █████ █ █ █ █ █ █ █ █ █ █
█ █     █     █   █   █ █   █     █ █   █ █ █   █ █     █ █ █   █ █ █ █ █   █ █   █ █ █ █ █ █ █ █   █
█████ ███ █████████ ███ █ ███████ █████ █ ███ ███████ ███ █████ █ █ █ █ ███ █ █ ███ █████ ███ █ ███ █
█     █ █   █   █   █     █         █     █     █       █ █   █ █ █ █         █   █ █ █ █   █     █ █
█ █████ ███ █ █████ █ █ █████ ███ █ █ ███ █████ █ █ ███ █████ ███ █████████ █████████ █ ███ ███ █████
█           █   █   █ █   █ █ █   █   █ █   █   █ █   █   █     █   █     █   █ █         █ █       █
███ █ ███ █████ ███████ ███ █████████ █ ███ ███████ █████ ███ █ █ ███████ ███ █ █ █ █ ███ █ █████ ███
█ █ █   █ █     █             █     █   █ █ █     █   █   █ █ █ █ █           █   █ █ █       █ █   █
█ █ █████████ ███████ ███████████ ███ ███ ███████ █████ █ █ ███ █ █████████ ███ █████████████ █ ███ █
█   █ █ █       █ █ █ █ █     █ █ █ █     █   █   █ █ █ █           █ █             █     █ █ █     █
█ █ █ █ █ █ █ ███ █ █ █ █ █████ █ █ ███████ ███ █ █ █ ███ █ █████ ███ █ ███ ███ █ ███ █████ ███ ███ █
█ █ █     █ █   █       █   █     █ █     █ █   █   █ █   █     █       █ █ █ █ █       █         █ █
███ ███ █ █ ███ ███ ███████ ███ █ █ ███ █ █ ███████ █ █████ █████ ███████ █ █ █ █ █ ███████████ █████
█ █ █   █ █   █ █       █   █   █ █   █ █   █ █   █   █     █ █   █   █ █   █   █ █   █   █         █
█ █ ███ ███████ █ █ ███████ ███ █████ █ █ ███ ███ ███ ███████ ███ ███ █ █████ ███ █████ ███ █ ███ █ █
█ █     █ █     █ █     █   █           █ █           █     █       █     █ █   █   █       █ █ █ █ █
█ █████ █ ███ ███ ███ █ █ ███ ███ █████ ███████ █████ ███ ███ ███████ ███ █ █ ███ ███ █████ ███ █████
█     █ █ █         █ █ █   █   █ █   █     █   █ █ █         █ █   █   █     █ █ █   █ █ █   █     █
█ ███████ ███ ███████ █ ███ █████ ███ ███ █████ █ █ █ █ █ █ ███ █ █ ███████████ ███ ███ █ █ ███ ███ █
█       █   █   █     █ █       █ █         █     █   █ █ █       █ █       █         █ █   █   █ █ █
█ █ █ █████ ███████████████████ █████ █ ███ █████ █ █ ███████ ███ █████ █ █████ ███████ ███ █████ █ █
█ █ █   █             █   █ █   █     █   █       █ █ █   █   █   █   █ █ █ █ █     █   █ █         █
█ ███████████████ ███ ███ █ █ █ █ ███ ███████ ███ ███████ █ █ ███ █ █ █ ███ █ █ ███ █ ███ █ ███ ███ █
█     █             █     █ █ █   █     █     █   █ █ █ █   █   █ █ █   █     █   █ █   █   █ █   █ █
█████ █ █ █████████████████ ███ ███ ███ ███ █ ███ █ █ █ █ █ █████ █ ███ █ █████████ █ █ ███ █ █ ███ █
█       █               █         █   █ █ █ █ █   █   █   █ █   █ █   █ █   █   █ █ █ █   █   █ █ █ █
█████ ███ █ ███████ █████████████████ ███ █ ███ ███ ███ ███ ███ █ █ ███████ █ ███ █████ █ ███ ███ █ █
█       █ █     █ █   █     █         █     █ █ █ █   █ █ █ █   █   █ █   █     █       █   █ █ █   █
█████ █ ███ █████ █ ███ ███ █ ███████ █████ █ ███ █ ███ █ █ ███ █████ █ ███ ███ ███ ███ ███ ███ █████
█   █ █ █     █ █     █   █ █ █   █ █     █ █ █ █ █   █ █   █   █   █   █   █   █   █ █ █ █       █ █
█ █ ███ ███ ███ ███ █ █ █████ █ ███ ███████ █ █ █ █ ███████████ ███ █ █████ █ █ █ ███ █ █ ███ █████ █
█ █ █   █       █ █ █   █       █     █   █         █     █     █     █ █ █ █ █ █ █   █   █       █ █
█ █████ █████ ███ █ █ █ ███ ███ █████ ███ ███ █ ███████ ███████ █ █████ █ █ █████████ █ ███ █ █████ █
█     █ █   █   █   █ █ █ █   █ █ █         █ █     █     █         █   █ █         █   █ █ █   █ █ █
█ █ █ ███ ███ █ ███████ █ █████ █ ███████ ███████ █ █ ███████ ███ █ ███ █ █ ███ █ █ ███ █ █ █████ █ █
█ █ █ █ █   █ █     █ █     █               █     █         █ █   █       █ █   █ █   █   █ █     █ █
█ █████ ███ █ █ █ ███ █ █ █ █ █ ███ ███ █ ███████████ █ █ █████████████ ███████ █ ███ ███ ███████ █ █
█ █   █       █ █   █ █ █ █ █ █   █ █ █ █ █   █ █   █ █ █ █     █ █   █     █ █ █ █ █   █     █     █
█ █ ███████████ █████ ███ ███ █ █████ ███ ███ █ ███ ███████ █████ ███ █████ █ █████ █ █ █████ ███ █ █
█ █   █   █ █   █   █ █       █ █     █   █ █         █ █   █     █   █ █     █     █ █     █   █ █ █
█ █ ███ ███ ███████ █ ███ ███ █████ ███ █ █ ███████ █ █ ███ █ ███ █ █ █ █ █ █ ███ █████ ███████ ███ █
█           █       █ █ █   █   █ █     █ █       █ █   █ █ █ █ █   █ █   █ █   █ █                 █
█ █ █ █████████ █████ █ ███ ███ █ █████ █████████ ███ ███ █ ███ █████ █ █████ ███ █ █████████ ███ ███
█ █ █             █     █     █ █ █ █ █   █ █     █   █             █   █   █         █     █   █   █
███████ ███ █ █ ███████ █████ ███ █ █ █ █ █ █████ ███ ███ █████████ █ █ ███ ███ █ █████ ███ █ █ ███ █
█     █   █ █ █     █     █       █     █     █     █     █   █   █   █ █   █   █   █   █ █   █ █   █
█ ███ █ ███ █████████ ███ ███ █████ ███ █ █ ███ ███ █████ ███ ███ █ █ ███ ███ ███ █████ █ █████ █████
█   █   █     █ █ █ █   █ █       █ █   █ █   █   █       █ █   █   █       █   █   █   █     █     █
███ █████ █████ █ █ █████ █ █ █ ███████ █ ███ █ █ █ █████ █ █ ███████ █ ███████ ███████ ███ █ █ ███ █
█       █   █ █ █ █ █   █   █ █ █ █ █ █ █ █     █ █   █     █     █   █ █ █   █       █     █ █ █ █ █
█ █████ █████ █ █ █ ███ █ ███████ █ █ ███ ███ █████ █████████ ███ █ ███ █ ███ █ █ █ ███████ ███ █ ███
█     █       █             █   █     █ █ █   █   █         █ █ █ █ █   █     █ █ █ █ █ █     █     █
█████ ███ ███ ███████ █ ███ ███ █████ █ █████ █ ███ ███ ███ █ █ ███████ ███ █ ███ █ █ █ █ █████ █ █ █
█ █   █ █ █ █   █   █ █   █   █     █ █       █   █ █     █           █     █ █   █ █     █     █ █ █
█ ███ █ █ █ ███████ █████████ █ █████ █████ ███ ███ ███ █ █████ █ █████ █ █ █████ ███████ ███████ ███
█ █ █ █     █       █       █   █       █   █ █     █   █     █ █   █ █ █ █ █ █         █ █ █ █ █   █
█ █ █ ███████ █████ █ █████████████ ███ █████ █ ███████ ███████ ███ █ ███ █ █ ███ █ ███ ███ █ █ █ ███
█             █   █ █   █       █ █   █ █ █ █       █ █   █ █     █   █   █ █ █ █ █   █ █           █
█ ███████ █ █████ █ █ █ ███████ █ █ █████ █ █████ ███ █████ █ █████ ███ ███ █ █ █ █ █ ███████ ███ ███
█     █   █   █   █ █ █ █   █ █   █   █ █ █ █ █     █ █   █   █ █ █   █ █ █ █     █ █     █   █     █
█ █ █████████ █ █ █████ █ █ █ █ ███ ███ █ █ █ ███ ███ █ ███████ █ ███ █ █ █ ███ █ █ █████ █ █████████
█ █   █ █       █ █       █   █ █ █ █   █     █       █   █   █       █ █ █ █   █ █ █     █ █   █   █
█ █████ █ █████ ███████ █ █ ███ █ █ ███ █████ ███ ███ █ ███ ███ █ █████ █ ███ ███ ███████████ ███ █ █
█       █     █     █ █ █ █     █       █ █   █   █ █ █   █     █   █   █ █   █   █               █ █
█ █ █████ ███████ ███ █████ ███ ███ █ █ █ ███ █ ███ █ ███ █ █ ███████████ █ █ █ ███ ███████ ███ █████
█ █ █   █   █                 █     █ █ █ █       █     █   █ █ █           █ █ █ █       █   █ █ █ █
█ █ █ █████████ █████ █ █ █ █████ ███ █ █ █ █████ ███ █ █ █████ █ █████ ███ █████ █ ███ █ █ ███ █ █ █
█ █ █             █   █ █ █   █     █ █     █     █   █ █   █ █     █ █   █ █ █ █   █ █ █ █ █   █   █
█ █████ █ █████████ ███ ███ ███ █████ █ ███ █████████████████ ███████ █ ███ █ █ █ ███ █████████████ █
█   █   █   █     █ █ █   █ █ █     █ █   █ █     █           █         █ █               █ █     █ █
█ █████████ ███ █████ ███████ █ █ █████ █ █ ███ █████████ ███████ █ █████ ███████████ █████ █ ███ █ █
█       █   █     █ █   █ █ █   █   █ █ █ █ █ █         █     █   █ █   █       █ █ █     █     █ █ █
█ ███ ███ █ █ ███ █ █ ███ █ █████ █ █ █ ███ █ ███ █ █ █ ███ █ ███ ███ █ █ █ █████ █ █████ ███ █████ █
█ █   █   █     █       █         █ █     █       █ █ █     █   █     █   █     █                    
███████████████████████████████████████████████████████████████████████████████████████████████████ B
