A  ██████████████████████████████████████████████████████████
   █  █                       █           █  █              █
█  █  ███████  ████  █  ████████████████  █  █  █  ███████  █
█        █     █     █           █        █     █        █  █
████  ████  █  ████  █  ███████  █  █████████████  ████  ████
█           █  █     █  █     █  █  █           █     █     █
█  █  █  ████  █  █  ███████  ████  █  ██████████  █  ████  █
█  █  █     █  █  █     █     █        █        █  █  █     █
██████████  ████  █  ████  █  █  █  ██████████  ████  ███████
█  █  █  █  █  █  █  █  █  █  █  █  █              █        █
█  █  █  ████  █  ████  █  █  ████  █  ████  █  █  █  ███████
█        █           █  █  █        █  █  █  █  █     █     █
████  ████  ████  █  █  █  ████  ████  █  ████  ████  ████  █
█              █  █     █  █     █  █  █  █        █     █  █
█  ████  ███████  █  ████  ████  █  ████  █████████████  █  █
█  █  █  █     █  █           █        █        █     █  █  █
████  █  █  ███████  ██████████  █  █  █  █  █  ████  █  █  █
█              █              █  █  █  █  █  █     █        █
████  █  █  ████  ████████████████  █  █  █  ███████  ████  █
█  █  █  █  █     █  █  █     █     █     █  █     █     █  █
█  ███████  ███████  █  █  ███████  █  ██████████  ████  ████
█           █        █        █     █        █     █  █  █  █
████  ██████████  ██████████  █  ████  █  ████  █  █  █  █  █
█     █           █        █  █     █  █        █     █     █
█  ███████  ████  ███████  █  ████  ████  ███████  ████  █  █
█        █     █  █                 █        █  █  █  █  █  █
█  ███████  ████████████████  ████  ████  ████  █  █  █  █  █
█     █  █                    █     █  █     █  █     █  █  █
█  ████  ████  █  ██████████  ████  █  ███████  ██████████  █
█  █  █        █     █     █     █     █  █                 █
█  █  ████  █  ████  ████  ███████  ████  █  ███████  █  █  █
█  █     █  █  █     █  █        █  █  █        █     █  █  █
███████  ██████████  █  █  █  █  ████  █  ███████  █  ███████
█     █                    █  █  █           █     █        █
████  █  ████  █  ██████████  ██████████  ████  █  ████  ████
█        █  █  █     █     █     █     █  █     █     █     █
█  ████  █  ███████  █  ███████  █  ████  ██████████  ████  █
█  █  █  █     █  █  █     █        █     █        █  █     █
█  █  █  █  ████  █  █  ████  ████  ████  ███████  █  █  ████
█  █     █                 █  █              █        █      
██████████████████████████████████████████████████████████  B
