A ###################################################################################################
                # #       #     # #         #           # # #     #   # #   # # # #         #   #   #
# ### # ##### ### ### # ### ### # # ##### # # ### # ##### # ### # # ### ### # # # # # # # # # ### ###
#   # #   #       # # #   # #       # #   # # #   #   #         # #       # #   #   # # # # #       #
####### ##### ##### ### ### # ##### # ########### ### ### ############# ### # ####### # # ### # # ###
#   # # #     #   #   #   # #   # #     #     #     # #               # #     #       # # #   # #   #
# # # # ##### ### # ##### # ##### # ##### # # ##### ######### # # ### # # ######### ####### # # # ###
# # #     #       #   #     #         #   # #     #         # # # #     # # #     #     # # # # # # #
# ########### # # # ### ####### ##### ##### ##### # # # # # # # ######### # # # ### ##### # ##### # #
# #       #   # # # # # # # # # # #   # #   #       # # # # # # #         #   #     #   #   #       #
# # # ########### # # # # # # ### ##### ####### # # ####### # # # ####### ######### # ##### ### #####
#   #     #     # # #   # #   # #   #       # # # # #   #     #     # # # # # # # #   #   #   # #   #
# ##### # # # # # # # # # # # # # # ### ### # ####### ##### ####### # # # # # # # ### # # # # ### ###
# # # # #   # # #   # # #   #     #   # # #     #       #   #   # # #   # #   #     #   #   # # #   #
# # # # ####### ### ### # ### # # ### # # ##### ##### # ##### ### ### # # ### ### # # # ####### # # #
#   #     #   #     #     #   # # #   #     # # #     # # #       # # # #   #   # #   #   #       # #
##### ### # ################# # # # # ### ### ### ##### # # # ### # ### ### # # # ### ##### ### ### #
#     # #           #     #   # # # #         #   #       # # # #   # #     # #   #     # #   #   # #
# ### # # # # ### ### ### ##### ##### # # ######### ####### # # ##### # # # # # # ####### # ####### #
#   #   # # #   #   #   #       # # # # #       #   #     # #     # # # # #   # #   #     #     # # #
##### # ##### ########### # ### # # ##### ####### # # ### ##### ### # ######### # ### # # ### ### # #
#   # # #       #   #   # # #     # #       #     # # #   #           #   # #   #   # # # #   #     #
# ### ### ##### # ##### # ##### # # ### ####### ### ### # # # ### ##### ### # ##### ##### # ####### #
# #   # #   #           # # #   #   #     #   #   #     #   # #   # #       # #   # #   #   #     # #
# # ### ####### ##### ##### ### ####### # # # # # # ##### ### ### # ####### # # ### ### ### ##### ###
#         # # #   #   #   #   # #     # #   # # # # #   # #   #     #   #         #   #     # #     #
# ### ### # # # ####### # ### ### # ### ##### # ####### ##### ### # ### # ### # ##### ### ### ### ###
# #     #     # #   # # # # #     #     #     # #   # #         # #         # #   # #         #     #
# # ### ### # ### ### ### # # ######### ######### ### ######### ### # # ### ####### # ### ##### #####
# # #   #   #   #   # #     # #       # #             # #   #   #   # #   #   # # # # #         #   #
### # ### ### ##### # ### # # # # # # # ##### ### ##### # # ####### # ### # ### # # ### ########### #
#   # # # #       #     # # # # # # # # #       # #     # # # #   # # # # # #   # #   # #         # #
# ### # ##### # ### ##### ### ### ### # # ##### ##### # # # # # ####### # ##### # # ####### # ##### #
# # #   #   # # #   #       # #     # #       # # #   #   # #       # #           #   # #   #     # #
### # # # ### ##### # # # ### # ### ### ### ### # # ######### ##### # ### ### ##### ### # ######### #
# #   #     #         # #   # # #         #   # #   # # #     #   # #       #   #   #   # # #       #
# # ##### ### ### # ### ########### ##### ### ### # # # # ### # # ### ######### # ##### # # ##### ###
#   #   # #     # # # # #         # #     # # #   # # #   # # # # #   #     #   #     # #     #     #
# ### ####### ##### # ##### # ######### # # ####### # # # # ### ### # ### ##### # ### # # # # # #####
#       # # # # # #         # # #       #         #   # #   # #   # # # # #   # #   #   # # #   #   #
# ##### # # # # # # ######### # ####### # ##### ##### # ### # # # # ### # ### # # ##### # ### ##### #
#     # #     # # #   # #     #   #   # #   # # #     # #   # # #   #     #     # # #   # #   #     #
# ########### # # # ### ######### ### # ### # # ### # # ##### # # ##### ### ### # # ##### ######### #
#     # #     #       #     #   #   #   #   #   #   #         # # # #         # #           # # #   #
# # ### # ##### ####### ### # # # ######### ### ########### # ##### # # # ### # ### ### # ### # ### #
# # # # # #       #       # # # #   #     #   #     #       #   #   # # # #   # #   #   #   #   #   #
# ### # ### # ####### ##### # # # # # ### # ##### ### ##### ### ### ### ##### ####### ######### ### #
# # #     # # # #     #     # #   #   #   # # #   #     #   # # #   #   #     # # #   # #   #     # #
# # # ### # # # ####### ### ##### ### ### ### # ### ### ### # ### ### ######### # ### # ### # # ### #
#       # # #       # # #   #   # #   # #     #     # #   # #           # #     #   # # #   # #   # #
### # # ####### ##### ### # ### ### # # # # ### ##### ##### # # ####### # ##### ### # # # ### # # # #
#   # #     # #   # # #   # #   #   #   # #         #   # #   # # # # # #       # #     #     # #   #
### # ### # # # ### # # # # # ##### # ######### # ### # # # ### # # # ### ### ### ### ### # ### ### #
#   # #   # #       # # # # #       # # # #   # # # # # # #   #     #   # # # #   #     # # # #   # #
### ####### ######### # ####### ### ### # # ####### ### # # ### ### # ##### # # ####### ### # ##### #
# # # #     #   # #   #       #   #   #   # #   #   # # # # #   #     #         # # # # # #       # #
# # # ### # # # # ### ### ######### ### ### # # ### # # # ### # ##### ####### ### # # # # ##### #####
#     #   #   # # # # #   #       # # #       # #   # #   # # # # #   #     #   #         # #     # #
# ########### # # # # ### ##### ### # # # ####### ### # ### # ### ### # ##### ######### # # ### ### #
# #           #   # # #   #             # #           #   #   #                         # #     #   #
# ##### ####### ### # # ### ######### # ######### ### ### ### ##### ### # ####### ####### ### ### # #
# # #       # #   #   #   #   # #     # #       #   #     #     #   # # #       # #     # #       # #
# # ##### # # # ##### ### # # # # ### # # ### ##### ####### ##### ### ### ##### ####### # # ##### ###
#     #   #   #       #   # # #   #   #   #     #   #   #       #       #     # #         #   # #   #
### ##### ####### ### # # # # ##################### # ##### ############# ########### # ####### # # #
# #   # # # #       # # #   # # #   #     #     # #   #         # # # #         #   # # #         # #
# # ### # # # # ####### ####### ### ##### ### # # # # # ######### # # ##### ### # # # ####### ### # #
#     #     # #     # #   #     #   #     # # #     # # #     #   # #       # #   # # #       # # # #
# ##### # ####### ### # # ### ##### ### ### # ##### # ### # # # ### ### # # # ### # # # # ### # # ###
#   #   # # #   #   #   #     # # #     # #   # # # # # # # # #       # # # #     # # # # #   # #   #
### ### # # ### # # # # # ##### # ### # # ### # # ##### # # ### ############### # ### # # # ### ### #
# #   # #   #     # # # # #   #   # # #   #     #   # # # #   #     # #   #   # #   # # # #     #   #
# # ######### ####### # # # ##### # # ### # ####### # # # # # ### ### # ### ### ### # # ##### # ### #
# #   #     #   # #   # # # #   #   # #         #     #   # #     #   #     #   #   #       # # #   #
# # ### # ### ### # ##### # # ### # # # ######### ### ####### ####### # # ##### # # ##### ######### #
#     # #   #   #       #   #   # #   #   #   # # #   #     #   # # # # # # # # # # #   #     #     #
# # ####### ######### # ### # ####### ### ### # ### ####### ### # # # ### # # ##### ### # ##### # # #
# # #   #   #         # # #       # #   #     #   # #               #         #       #   # #   # # #
### ### # ### ### ##### # # ### # # # # ### ### # # ####### ### ##### ####### ### # ### # # ##### ###
# #   #     # # #   #   #     # #     # # #     #   #   #     # # #         # #   #   # #   # # # # #
# # ### ####### # ####### # ##### ### ### # ####### # # ### # ### ######### ####### # ####### # # # #
# #   # #     #     # #   # # # # #   # #       # #   # #   #       # #     #   # # # #     #   #   #
# # ### ### # ### ### ### ### # # ### # ######### ##### ### ####### # # ### ### # # # # ### ### #####
#     # #   #           # # # #   #   # # #     # #         # #       # # # # #     #     #       # #
# # ### ### ### # ######### # ### ##### # # ##### ### # # # # # # # ### # # # ##### # ### ### # ### #
# #   #   # #   # # # #     # #   # #   #   # #       # # #   # # # #     #     # # #   #   # #     #
# ##### ######### # # # ##### # # # ### ### # ######### ##### ####### # # ### ### ### ### ### #######
#         #         #   #       # #         #   #   #     #   # #     # #   #   #       # #   #     #
### ### # # # ### ### ### # ##### # # # ### # ##### ### # ### # ##### ######### ### ####### # # #####
#   # # #   # #     # #   #   #     # # #   #         # # # #       # #   # #   #     #   # #       #
##### ### ### ### # # ### # ####### # ### # ####### ####### ### # ### ### # # ########### # ##### ###
#         #     # # #     #   # #   # #   #   #   #   #   #     # #     # #           #     # #     #
##### ### ########### ####### # ######### ### ### ### ### # # ### ### # # ##### ##### ### ### ##### #
#       # #   #   #   #   #       # #   #   #       # #   # #   # #   #   #   #     #           # # #
####### ##### # # ####### # ####### # ########### ### ### ########### ### # # ####### ### ### ### # #
# # #     #     #     # # #       #     #     #   #           #   # # #   # #       #   # #   # #   #
# # # # ### # ### # # # # ### ### ##### # ####### ##### ##### # ### # # # ### ### ####### # # # ### #
#   # # #   # #   # # #   #   #       # #   #           #         #   # # #     # # #     # # #     #
### ### ### ### ####### # # ### # # ### # ##### ##### ####### ##### ### ######### # ### ####### ### #
#           #     #     #   #   # #           #     # #       #     #     #                 #     #  
################################################################################################### B
